#################################
#...HSS.........................#
#...............................#
#...............................#
#...............................#
#...............................#
#...............................#
#.............A.................#
#...............................#
#################################
10